{
  "A": "北部",
  "B": "中部",
  "C": "北部",
  "D": "南部",
  "E": "南部",
  "F": "北部",
  "G": "東部",
  "H": "北部",
  "J": "北部",
  "K": "中部",
  "L": "中部",
  "M": "中部",
  "N": "中部",
  "P": "中部",
  "Q": "南部",
  "R": "南部",
  "S": "南部",
  "T": "南部",
  "U": "東部",
  "V": "東部",
  "X": "離島",
  "Y": "北部",
  "W": "離島",
  "Z": "離島",
  "I": "南部",
  "O": "北部"
}
